1111
10P1
1101
1C01
1001
1101
10E1
1111